=:=:=:=:=:=:=:=:=:=:=:=:=:=:=:=:=:=:=:=:=:=:=:=:=:=:=:=:=:=:=:=:=:=:=:=:=:=:=:=:=:=:=:=:=:=:=:=:=:=:=:=:=:=:=:=:=:=:=:=:=:=:=:=:=:=:=:=:=:=:=:=:=|=========================|
#           #           #           #           #           #           #           #           #           #           #           #           #|                         |
#           #           #           #           #           #           #           #           #           #           #           #           #|                         |
#           #           #           #           #           #           #           #           #           #           #           #           #|                         |
#           #           #           #           #           #           #           #           #           #           #           #           #|                         |
#           #           #           #           #           #           #           #           #           #           #           #           #|                         |
=:=:=:=:=:=:=:=:=:=:=:=:=:=:=:=:=:=:=:=:=:=:=:=:=:=:=:=:=:=:=:=:=:=:=:=:=:=:=:=:=:=:=:=:=:=:=:=:=:=:=:=:=:=:=:=:=:=:=:=:=:=:=:=:=:=:=:=:=:=:=:=:=|                         |
#           #                                                                                                                       #           #|                         |
#           #                                                                                                                       #           #|                         |
#           #                                                                                                                       #           #|                         |
#           #                                                                                                                       #           #|                         |
#           #                                                                                                                       #           #|                         |
=:=:=:=:=:=:=                                                                                                                       =:=:=:=:=:=:=|                         |
#           #                                                                                                                       #           #|                         |
#           #                                                                                                                       #           #|                         |
#           #                                                                                                                       #           #|                         |
#           #                                                                                                                       #           #|                         |
#           #                                                                                                                       #           #|                         |
=:=:=:=:=:=:=                                                                                                                       =:=:=:=:=:=:=|                         |
#           #                                                                                                                       #           #|                         |
#           #                                                                                                                       #           #|                         |
#           #                                                                                                                       #           #|                         |
#           #                                                                                                                       #           #|                         |
#           #                                                                                                                       #           #|                         |
=:=:=:=:=:=:=                                                                                                                       =:=:=:=:=:=:=|                         |
#           #                                                                                                                       #           #|                         |
#           #                                                                                                                       #           #|                         |
#           #                                                                                                                       #           #|                         |
#           #                                                                                                                       #           #|                         |
#           #                                                                                                                       #           #|                         |
=:=:=:=:=:=:=                                                                                                                       =:=:=:=:=:=:=|                         |
#           #                                                                                                                       #           #|                         |
#           #                                                                                                                       #           #|                         |
#           #                                                                                                                       #           #|                         |
#           #                                                                                                                       #           #|                         |
#           #                                                                                                                       #           #|                         |
=:=:=:=:=:=:=:=:=:=:=:=:=:=:=:=:=:=:=:=:=:=:=:=:=:=:=:=:=:=:=:=:=:=:=:=:=:=:=:=:=:=:=:=:=:=:=:=:=:=:=:=:=:=:=:=:=:=:=:=:=:=:=:=:=:=:=:=:=:=:=:=:=|                         |
#           #           #           #           #           #           #           #           #           #           #           #           #|                         |
#           #           #           #           #           #           #           #           #           #           #           #           #|                         |
#           #           #           #           #           #           #           #           #           #           #           #           #|                         |
#           #           #           #           #           #           #           #           #           #           #           #           #|                         |
#           #           #           #           #           #           #           #           #           #           #           #           #|                         |
=:=:=:=:=:=:=:=:=:=:=:=:=:=:=:=:=:=:=:=:=:=:=:=:=:=:=:=:=:=:=:=:=:=:=:=:=:=:=:=:=:=:=:=:=:=:=:=:=:=:=:=:=:=:=:=:=:=:=:=:=:=:=:=:=:=:=:=:=:=:=:=:=|=========================|